NO ./img/bound_north.xpm
SO ./img/bound_south.xpm
WE ./img/bound_west.xpm
EA ./img/bound_east.xpm

F 100,100,100
C 0,0,0


111111111111111111111111111
1000100000100000000000001
1011000001110000000000001
11010000000000000000000011111111     
11111111101000001110000000000001111111
100000000011000001110111111111111
11110111111111011100000010001
11110111111111011101010010001
11000000110101011100000010001
10000000100000000100000010001
1000000000000010S000001000111                   1111111111
110000011101010101110111100111                  1110000001
11110111 1110101 101111010001                   111111111
    1111 1111111 111111111111
111111111111111111111111111111
11111111
10000001
11111111

