NO ./img/bound_north.xpm
SO ./img/bound_south.xpm
WE ./img/bound_west.xpm
EA ./img/bound_east.xpm


F 0,0,0
C 0,0,0


111111111111111111111111111
1000100000100000000000001
1011000001110000000000001
1101000000000000000000001111111      
11111111101000001110000000000001111111
100000000011000001110111111111111
11110111111111011100000010001
11110111111111011101010010001
11000000110101011100000010001
10000000000000001100000010001
10000000000E0001101010010001
110000011101010111110111100111
11110111 1110101 101111010001
11111111 1111111 111111111111
111111111111111111111111111111
